MAZE: "mylevel",' '
INIT_MAP:solidfill,' '
GEOMETRY:left,top
MAP
.........
.........
.........
.........
.........
.........
.........
FF.......
.F.......
ENDMAP
REGION:(0,0,9,9),lit,"ordinary"
IF [50%] {
    MONSTER: ('j', "blue jelly"),(0,8),asleep
    TRAP:"pit", (0,0)
    TRAP:"board", (8,0)
} ELSE {
    MONSTER: ('F', "lichen"),(0,8),asleep
    TRAP:"pit", (8,0)
    TRAP:"board", (0,0)
}
BRANCH:(2,8,2,8),(3,8,3,8)