MAZE: "mylevel",' '
INIT_MAP:solidfill,' '
GEOMETRY:left,top
MAP
----------------------
|........|...|.......|
|........|.|.|.......|
|........|.|.|.......|
|........|.|.|.......|
|..........|.........|
----------------------
ENDMAP
REGION: (0,0,21,79), lit, "ordinary"
BRANCH: (1,1,1,1), (1,2,1,2)
STAIR: (20, 5), down