MAZE: "mylevel",' '
INIT_MAP:solidfill,' '
GEOMETRY:left,top
MAP
.........
.........
.........
------...
.....F...
.....F...
.....F...
.....F...
.....F...
ENDMAP
REGION:(0,0,9,9),lit,"ordinary"
IF [50%] {
    MONSTER: ('j', "blue jelly"),(0,8),asleep
    TRAP:"pit", (0,0)
    TRAP:"board", (8,0)
} ELSE {
    MONSTER: ('F', "lichen"),(0,8),asleep
    TRAP:"pit", (8,0)
    TRAP:"board", (0,0)
}
BRANCH:(6,8,6,8),(7,8,7,8)