MAZE: "mylevel",' '
INIT_MAP:solidfill,' '
GEOMETRY:left,top
MAP
|.|----
-F----.
|......
------.
ENDMAP
REGION:(0,0,6,4),lit,"ordinary"
IF [50%] {
    MONSTER: ('j', "blue jelly"),(1,0),asleep
    TRAP:"pit", (6,1)
    TRAP:"board", (6,3)
} ELSE {
    MONSTER: ('F', "lichen"),(1,0),asleep
    TRAP:"pit", (6,3)
    TRAP:"board", (6,1)
}
BRANCH:(1,2,1,2),(2,2,2,2)